11111111111111111111
1CPCCCCCCCCCCCCCCC01
1C111111111111111C01
1C1C111111111111C001
1C1C1C111111111C0001
1C1C1C1C111111000C01
1C1C1C1C1C111C000001
1C1C1C0C1C0C1C000001
1C1C0C1C1C1C1C000001
1C1C1C1C0C1C000000E1
11111111111111111111
